#######
#A    #
### ###
#     #
# ### #
#   B #
#######
