##############################
#A      ##      #       #     #
##### # ##### # # ##### ##### #
#   # #     # #   #   #     # #
### ##### ##### ####### ### # #
#     # #   #     #       #   #
##### # ### # ##### ####### ###
#     #             #       B #
# ####### ######### ####### ###
# #       #       #   #     # #
# ####### ####### ### ##### # #
#   #   #       #   #   #     #
# ### # ######### ##### #######
#     #       #       #        #
##############################
