###############
#A        #   #
##### ####### #
#       #     #
# ### # ##### #
#  B  #       #
###############
